acc: accounting
accg: accounting
acous: acoustics
acust: acoustics
add: addiction
addict: addiction
addr: address
addre: address
aero: aerospace
agg: aggregate
agri: agriculture
alg: algebra
anal: analysis
anlys: analysis
anat: anatomy
anim: animation
anthro: anthropology
apt: apartment
appt: appointment
arch: architecture
athlet: athletics
attach: attachment
auth: authentication
auto: automotive
bank: banking
biochem: biochemistry
biog: biography
bio: biology
biomed: biomedical
biophys: biophysics
biotech: biotechnology
bot: botany
bus: business
busn: business
calc: calculus
camp: camping
cardio: cardiology
carto: cartography
cat: category
categ: category
ceo: chief executive officer
cfo: chief financial officer
coo: chief organizational officer
cto: chief technology officer
chem: chemistry
col: colour
color: colour
comm: communication
compsci: computer science
cs: computer science
comp: computing
confid: confidence
conform: conformity
cook: cooking
coop: cooperation
cooperat: cooperation
cosmet: cosmetology
creativ: creativity
curr: currency
cust: customer
cycl: cycling
dob: date of birth
deg: degree
demog: demography
dendrol: dendrology
depend: dependence
dermatol: dermatology
desc: description
descrip: description
develop: development
diplom: diplomacy
direct: direction
dist: distance
dive: diving
dom: dominance
dq: data quality
dr: doctor
eco: ecology
econ: economics
edu: education
elec: electricity
endo: endocrinology
eng: engineering
ent: entertainment
enth: enthusiasm
ento: entomology
env: environment
envsci: environmental science
epi: epidemiology
epist: epistemology
eq: equality
eth: ethnology
ety: etymology
exp: experience
fail: failure
ferm: fermentation
fin: finance
fire: fire fighting
fish: fishing
foodsci: food science
for: forestry
faq: frequently asked questions
gen: genetics
geo: geography
geom: geometry
geron: gerontology
gdp: gross domestic product
gym: gymnastics
hea: health
herp: herpetology
hik: hiking
hist: history
hort: horticulture
hosp: hospitality
hr: human rights
hum: humidity
hunt: hunting
hydro: hydrology
ich: ichthyology
imm: immunology
inddes: industrial design
infdis: infectious diseases
intrel: international relations
iq: inteligence quotient
ip: internet protocol
just: justice
kinem: kinematics
kines: kinesiology
lab: laboratory
lang: language
ltr: letter
lettr: letter
lexic: lexicology
lib: liberty
limn: limnology
ling: linguistics
lit: literature
loc: location
machlearn: machine learning
ml: machine learning
malac: malacology
manag: management
mgmt: management
marbio: marine biology
mrkt: marketing
martarts: martial arts
math: mathematics
max: maximum
mech: mechanics
med: medicine
mem: memory
meta: metaphysics
mil: military
min: minimum
mod: model
moto: motorcycle
mov: movie
mus: music
mycol: mycology
myst: mystery
myth: mythology
nano: nanotechnology
narr: narrative
natsci: natural science
nat: nature
nephr: nephrology
netw: networking
neurobio: neurobiology
neurol: neurology
neurosci: neuroscience
nr:number
numer: numerology
numis: numismatics
nurs: nursing
nutr: nutrition
oceano: oceanography
odonto: odontography
oper: operations
optom: optometry
ornith: ornithology
ptg: painting
pal: paleontology
pars: parasitology
path: pathology
pay: payment
pymt: payment
pmt: payment
perc: percentage
pct: percentage
pt: petroleum
petr: petrology
pharm: pharmacy
philanth: philanthropy
philol: philology
philos: philosophy
phn: phone
phon: phonetics
photochem: photochemistry
photog: photography
phys: physics
physiol: physiology
plansci: planetary science
plumb: plumbing
poet: poetry
pol: police
politsci: political science
polit: politics
pop: population
pow: power
pri: price
prid: pride
primatol: primatology
prod: product
prof: professor
prog: programming
psycholing: psycholinguistics
psych: psychology
psychophys: psychophysics
pubhealth: public health
pubrel: public relations
publ: publishing
pulm: pulmonology
qual: quality
qlty: quality
qa: quality assurance
qty: quantity
qt: quantity
quantcomp: quantum computing
quantmech: quantum mechanics
quantphys: quantum physics
radiol: radiology
reest: realestate
rec: recreation
recy: recycling
reg: region
rehab: rehabilitation
reliab: reliability
renen: renewableenergy
resmgmt: resource management
resp: responsible
ret: retired
rheo: rheology
robo: robotics
run: running
sav: savings
sci: science
sculp: sculpture
sd: standard deviation
sec: security
secy: security
selfimp: self improvement
selfest: self-esteem
semio: semiotics
serv: service
simul: simulation
siz: size
ski: skiing
socc: soccer
socbio: sociobiology
socio: sociology
softdev: software development
softeng: software engineering
sol: solution
sou: sound
spaceexp: space exploration
spec: spectroscopy
spe: speed
spo: sport
sposci: sports science
std: standard
stddev: standard deviation
stat: statistics
surg: surgery
sust: sustainability
sym: symbolism
synbio: synthetic biology
sys: system
taxi: taxidermy
taxo: taxonomy
team: teamwork
tech: technology
tel: telecommunications
temp: temperature
thea: theatre
theo: theology
ther: therapy
thermo: thermodynamics
tim: time
tit: title
topo: topology
tour: tourism
toxic: toxicology
trad: tradition
train: training
tran: transaction
trans: translation
trav: travel
tru: trust
txt: text
typo: typography
unemp: unemployment
uni: university
urbplan: urban planning
urb: urbanism
vaca: vacation
vacc: vaccine
val: value
vat: value added tax
veh: vehicle
vel: velocity
ven: vendor
ves: vessel
vetmed: veterinary medicine
vetsci: veterinary science
vic: victory
vict: victory
viro: virology
vis: vision
visart: visualart
volc: volcano
volv: volcanology
vort: vortex
wea: weather
wei: weight
wgt: weight
wood: woodworking
xeno: xenobiology
